# #########################
# #  #               #    #
#   ## ###### ######   ## #
###    ####   #      ###  #
# # ###   ###   # # #    ##
#       #     ##  #   #    
###########################