# #########################
# #  #               #    #
#   ## ## ### ######   ## #
###    #  #          ###  #
# # # ## ## # # # # #   # #
# # ###   ###   # # # #   #
#       #     ##  #   ###  
###########################